%%%%%%%%%%%%%%%%%%%%%%
%  B                 %
%                    %
%                  B %
%          %         %
%B     %   T   %     %
%       %    %       %
%        %           %
%                    %
%                   B%
%%%%%%%%%%%%%%%%%%%%%%
