%%%%%%%%%%%%%%%%%%%%%%
%B%%$$$$$$$$$$$$$$$$$%
%%%%$$$$$$$$$$$$$$$$$%
%%%$$$$$$$$$$$$$$$$$$%
%$$$$$$$$$$$$$$$$$$$$%
%$$$$$$$$$$$$$$$$$$$$%
%$$$$$$$$$$$$$$$$$$$$%
%$$$$$$$$$$$$$$$$$$$$%
%$$$$$$$$$$$$$$$$$$$B%
%%%%%%%%%%%%%%%%%%%%%%
