%%%%%%%%%%%%%%%%%%%%%%
%$$$$$$$$$$$$$$$$$$$$%
%$$$$$$$$$$$$$$$$$$$$%
%$$$$$$$$$$$$$$$$$$$$%
%$$$$$$$$$$$$$$$$$$$$%
%$$$$$$$$$B$$$$$$$$$$%
%$$$$$$$$$$$$$$$$$$$$%
%$$$$$$$$$$$$$$$$$$$$%
%$$$$$$$$$$$$$$$$$$$$%
%%%%%%%%%%%%%%%%%%%%%%
