%%%%%%%%%%%%%%%%%%%%%%
%$$$$$$$$$$$$$$$$$$$$%
%$$$$$$$$$$$$$$$$$$$$%
%$$$$$BVV       $$$$$%
%$$$$$VVV V     $$$$$%
%$$$$$ V      V $$$$$%
%$$$$$       VVV$$$$$%
%$$$$$    V  VVB$$$$$%
%$$$$$$$$$$$$$$$$$$$$%
%%%%%%%%%%%%%%%%%%%%%%
