%%%%%%%%%%%%%%%%%%%%%%
%B%%$$$$$$$$$$$$$$$$$%
%%%%$$$$$$$$$$$$$$$$$%
%%%$$$$$$$$$$$$$$$$$$%
%$$$$$$$$$$$$$$$$$$$$%
%$$$$$$$$$B$$$$$$$$$$%
%$$$$$$$$$$$$$$$$$$$$%
%$$$$$$$$$$$$$$$$$$$$%
%$$$$$$$$$$$$$$$$$$$$%
%%%%%%%%%%%%%%%%%%%%%%
