%%%%%%%%%%%%%%%%%%%%%%
%B                  E%
%                    %
%                    %
%                    %
%                    %
%                    %
%                    %
%E                   %
%%%%%%%%%%%%%%%%%%%%%%

