%%%%%%%%%%%%%%%%%%%%%%
% B                  %
%    B               %
%                    %
%          %         %
%                    %
%             B      %
%        %           %
%                  $$%
%                 $$V%
%%%%%%%%%%%%%%%%%%%%%%
